11111111111
10K00C100E1
1011011K101
100K0010001
1C1010P0101
11101101101
100K01001K1
1001C10C001
11111111111