1111111111111
1P01000K100E1
10000100C0111
1111111111111