1111111111111111111
1CCCCCCCC1CCKCCCCC1
1C11C111C1C111C11C1
1CCCKCCCCCCCCCCCCC1
1C11C1C11111C1C11C1
1CCCC1CCC1CCC1CCCC1
1111C111C1C111C1111
1111C1CCCCCCC1C1111
1111C1C11C11C1C1111
1LCCCCC10E01CKCCCR1
1111C1C11C11C1C1111
1111C1CCCCCCC1C1111
1111C111C1C111C1111
1CCCC1CKC1CCC1CCCC1
1C11C1C11111C1C11C1
1CCCCCCCCCCCCCCCKC1
1C11C111C1C111C11C1
1CCCCPCCC1CCCCCCCC1
1111111111111111111